10 10
7 5
          
   ####   
 ##. & #  
#. &    # 
#&      # 
#.     @# 
 #.&#   # 
  #.  &#  
   #   #  
    ###   
