10 10
#---------
-#--------
--#-------
---#------
----#-----
-----#----
------#---
-------#--
--------#-
---------#
