10 10
4 5
----------
----------
----------
----------
---###----
---#@#----
---#&#----
---#.#----
---###----
----------
10 10
5 5
----------
----------
----------
--#######-
--#---&.#-
--#--@&.#-
--#-----#-
--#######-
----------
----------
